width 40
height 10
########################################
#O#.......##................##.........#
#.#................H...................#
#.........##................##.........#
#..###############.##############.######
#..###############H##############H######
#.##..#...............##....##$........#
#.#...#.####..##########..#.#######....#
#...#......H..............#............#
########################################
